111111111111111
111111111111111
112111111111111
111111111111111
111111110111111
111111110111111
111111110111111
111111110111111
111111110111111
000000000001111
111111111101111
111111113101111
111111111101111
100000000001111
111111111111111
