¦¦¦¦¦¦¦¦¦¦¦¦¦¦¦¦¦¦¦¦¦¦¦¦¦¦¦¦¦¦¦¦¦¦¦¦¦¦¦¦¦¦¦¦¦¦¦¦¦¦¦¦¦¦¦¦¦¦¦¦¦¦¦¦¦¦¦¦¦¦¦¦¦¦¦¦¦¦¦¦
              ¦       ¦                   ¦¦¦¦¦¦¦¦               ¦             d 
¦ ¦¦¦ ¦¦¦¦¦¦¦¦¦ ¦¦¦¦¦ ¦ ¦¦¦¦¦¦¦¦¦¦¦¦¦¦¦¦¦¦¦    ¦   ¦¦¦¦¦¦¦¦¦¦¦¦¦ ¦¦¦¦¦¦ ¦¦¦¦¦¦¦¦
¦ ¦ ¦       ¦ ¦     ¦ ¦ ¦      ¦     ¦ ¦¦¦¦¦ ¦ ¦¦¦ ¦¦   ¦   ¦  ¦            ¦  ¦
¦ ¦ ¦ ¦¦¦¦¦¦¦ ¦ ¦¦ ¦¦ ¦ ¦  ¦ ¦   ¦ ¦ ¦ ¦   ¦ ¦      ¦ ¦   ¦   ¦¦¦¦¦¦¦ ¦     ¦  ¦
¦   ¦ ¦       ¦  ¦ ¦  ¦ ¦¦¦¦ ¦¦¦¦¦¦¦ ¦ ¦ ¦ ¦¦¦ ¦¦¦¦ ¦¦¦ ¦¦¦¦¦¦¦¦    ¦ ¦¦¦¦¦ ¦  ¦
¦¦¦¦¦ ¦ ¦¦¦¦ ¦¦¦ ¦ ¦ ¦¦    ¦       ¦ ¦ ¦ ¦        ¦  ¦           ¦¦ ¦     ¦ ¦  ¦
¦   ¦ ¦    ¦     ¦ ¦ ¦¦¦¦¦ ¦ ¦¦¦¦¦ ¦ ¦ ¦ ¦¦¦¦¦¦¦¦¦¦¦ ¦¦¦¦¦¦¦¦¦¦¦¦¦  ¦ ¦ ¦ ¦ ¦  ¦
¦ ¦ ¦ ¦¦ ¦¦¦¦¦¦¦¦¦ ¦               ¦   ¦           ¦ ¦              ¦ ¦ ¦ ¦    ¦
¦ ¦ ¦    ¦         ¦ ¦¦¦¦¦¦¦¦¦¦¦¦¦¦¦¦¦¦¦¦¦¦¦¦¦¦¦¦¦ ¦ ¦ ¦¦¦¦¦¦¦¦¦¦¦¦¦¦ ¦ ¦ ¦¦¦¦¦¦
¦ ¦ ¦¦¦¦¦¦ ¦¦¦ ¦¦¦¦¦¦¦    ¦            ¦       ¦   ¦   ¦            ¦ ¦ ¦ ¦    ¦
¦ ¦        ¦ ¦         ¦¦ ¦ ¦¦¦¦¦¦¦¦ ¦¦¦ ¦¦¦¦¦¦¦ ¦¦¦¦¦¦¦ ¦¦¦¦¦¦¦¦¦¦¦¦¦¦ ¦ ¦¦¦¦ ¦
¦ ¦¦¦¦¦¦¦¦¦¦ ¦ ¦¦¦¦¦¦¦¦¦¦¦¦ ¦      ¦ ¦   ¦   ¦ ¦ ¦       ¦  ¦      ¦    ¦      ¦
¦          ¦ ¦ ¦   ¦   ¦    ¦ ¦¦¦¦ ¦ ¦ ¦   ¦   ¦ ¦ ¦¦¦¦¦¦¦  ¦ ¦¦¦¦ ¦¦¦¦¦¦¦¦¦¦¦ ¦
¦¦¦¦¦¦¦¦¦¦ ¦ ¦ ¦ ¦ ¦ ¦   ¦  ¦  ¦   ¦ ¦ ¦¦¦¦¦¦¦¦¦ ¦ ¦     ¦  ¦ ¦  ¦           ¦ ¦
¦¦   ¦   ¦ ¦ ¦ ¦¦¦ ¦ ¦¦¦¦¦¦¦¦  ¦   ¦               ¦ ¦¦¦ ¦  ¦ ¦  ¦¦¦¦¦ ¦¦¦¦¦¦¦ ¦
¦  ¦   ¦   ¦ ¦     ¦  ¦   ¦ ¦ ¦¦ ¦¦¦ ¦¦¦¦¦¦¦¦¦¦¦¦¦¦¦ ¦ ¦    ¦        ¦         ¦
¦ ¦¦¦¦¦¦¦¦¦¦ ¦¦¦¦¦¦¦¦ ¦ ¦ ¦ ¦        ¦               ¦ ¦ ¦¦¦¦¦¦¦¦¦¦¦ ¦¦¦¦¦¦¦¦¦¦¦
¦                       ¦   ¦¦¦¦¦¦¦¦¦¦ ¦¦¦¦¦¦¦¦¦¦¦¦¦¦¦ ¦           ¦            
¦¦¦¦¦¦¦¦¦¦¦¦¦¦¦¦¦¦¦¦¦¦¦¦¦¦¦¦¦¦¦¦¦¦¦¦¦¦¦¦¦¦¦¦¦¦¦¦¦¦¦¦¦¦¦¦¦¦¦¦¦¦¦¦¦¦¦¦¦¦¦¦¦¦¦¦¦¦¦¦