¦¦¦¦¦¦¦¦¦¦¦¦¦¦¦¦¦¦¦¦¦¦¦¦¦¦¦¦¦¦¦¦¦¦¦¦¦¦¦¦¦¦¦¦¦¦¦¦¦¦¦¦¦¦¦¦¦¦¦¦¦¦¦¦¦¦¦¦¦¦¦¦¦¦¦¦¦¦¦¦
         ¦   ¦                           ¦¦¦¦  ¦     ¦  ¦ ¦     ¦   ¦   ¦   ¦ ¦¦
¦¦¦¦¦¦¦    ¦   ¦¦ ¦  ¦¦¦¦¦  ¦¦¦¦¦¦¦¦¦¦¦¦  ¦¦     ¦ ¦    ¦ ¦ ¦¦    ¦   ¦ ¦ ¦ ¦  ¦
¦¦ ¦  ¦ ¦¦¦¦¦¦  ¦ ¦      ¦¦  ¦  ¦   ¦  ¦¦  ¦¦ ¦¦¦¦¦¦¦¦¦     ¦  ¦¦¦¦¦¦¦¦¦¦ ¦ ¦ ¦¦
¦  ¦ ¦¦ ¦    ¦¦ ¦¦¦¦¦¦   ¦  ¦¦  ¦¦ ¦¦      ¦        ¦ ¦¦¦¦¦¦¦¦        ¦   ¦    ¦
¦¦ ¦ ¦  ¦  ¦¦¦  ¦    ¦ ¦¦¦¦¦¦¦         ¦  ¦¦¦¦¦¦¦ ¦ ¦   ¦    ¦ ¦¦¦¦¦¦¦¦¦¦¦¦¦¦¦¦¦
¦  ¦ ¦  ¦¦ ¦ ¦  ¦¦¦          ¦¦¦¦¦¦¦¦¦¦¦    ¦     ¦   ¦   ¦¦ ¦                 ¦
¦ ¦¦ ¦  ¦  ¦ ¦¦¦¦¦¦¦¦¦¦¦¦¦¦¦ ¦  ¦      ¦¦¦¦ ¦ ¦¦¦¦¦¦¦¦¦¦¦¦¦¦ ¦¦¦¦¦¦¦¦¦¦¦¦¦¦¦¦¦ ¦
¦       ¦                    ¦¦ ¦¦¦¦ ¦¦¦    ¦ ¦   ¦          ¦   ¦    ¦        ¦
¦¦¦¦¦¦¦ ¦¦¦¦¦¦¦¦ ¦¦¦¦¦¦¦¦¦¦¦¦¦  ¦        ¦¦   ¦   ¦¦¦¦   ¦¦¦¦¦ ¦ ¦ ¦  ¦ ¦¦¦¦¦¦ ¦
¦     ¦ ¦  ¦   ¦             ¦ ¦¦ ¦¦¦   ¦¦¦¦¦¦¦¦¦ ¦    ¦       ¦   ¦    ¦      ¦
¦¦ ¦¦¦¦   ¦   ¦¦¦¦¦¦¦¦¦¦¦¦¦¦ ¦    ¦ ¦¦¦ ¦   ¦   ¦ ¦    ¦¦¦¦¦¦¦¦¦¦¦¦¦¦¦¦¦¦¦¦¦¦¦ ¦
¦   ¦ ¦¦¦¦¦¦¦  ¦             ¦ ¦  ¦     ¦ ¦   ¦      ¦¦¦    ¦   ¦   ¦   ¦   ¦  ¦
¦¦  ¦       ¦  ¦¦ ¦¦¦¦¦¦¦¦¦¦¦¦¦¦¦¦¦¦¦¦¦¦¦¦¦¦¦¦¦¦¦¦ ¦   ¦  ¦   ¦   ¦   ¦   ¦    ¦
¦        ¦     ¦     ¦   ¦  ¦ ¦¦          ¦        ¦   ¦  ¦¦¦¦¦¦¦¦¦¦¦¦¦¦¦¦¦¦¦¦ ¦
¦   ¦¦¦¦¦¦¦¦¦¦¦¦   ¦   ¦    ¦ ¦   ¦¦¦¦¦¦¦ ¦¦¦¦¦¦¦¦¦¦¦¦¦¦¦¦¦            ¦   ¦   ¦
¦ ¦¦¦ ¦   ¦  ¦     ¦¦¦¦¦¦¦¦¦¦ ¦ ¦  ¦  ¦   ¦           ¦   ¦¦¦¦¦¦¦¦¦¦¦¦ ¦ ¦ ¦ ¦ ¦
¦   ¦ ¦ ¦ ¦ ¦¦ ¦¦¦  ¦   ¦   ¦ ¦ ¦¦¦¦¦ ¦¦¦¦¦¦¦¦¦¦¦¦¦¦  ¦   ¦    ¦     ¦ ¦ ¦ ¦ ¦ ¦
¦ ¦     ¦ ¦    ¦      ¦   ¦ ¦ ¦                         ¦   ¦    ¦       ¦   ¦  
¦¦¦¦¦¦¦¦¦¦¦¦¦¦¦¦¦¦¦¦¦¦¦¦¦¦¦¦¦¦¦¦¦¦¦¦¦¦¦¦¦¦¦¦¦¦¦¦¦¦¦¦¦¦¦¦¦¦¦¦¦¦¦¦¦¦¦¦¦¦¦¦¦¦¦¦¦¦¦¦