¦¦¦¦¦¦¦¦¦¦¦¦¦¦¦¦¦¦¦¦¦¦¦¦¦¦¦¦¦¦¦¦¦¦¦¦¦¦¦¦¦¦¦¦¦¦¦¦¦¦¦¦¦¦¦¦¦¦¦¦¦¦¦¦¦¦¦¦¦¦¦¦¦¦¦¦¦¦¦¦
    ¦        ¦  ¦   ¦   ¦ ¦                           ¦        ¦   ¦ ¦         ¦
¦ ¦    ¦¦¦¦¦   ¦¦ ¦   ¦   ¦ ¦¦¦¦¦¦ ¦¦¦¦¦¦¦¦¦¦¦¦¦¦¦¦¦¦¦¦ ¦¦¦¦¦¦ ¦ ¦ ¦ ¦ ¦¦¦¦¦¦  ¦
¦ ¦¦¦¦ ¦   ¦ ¦    ¦ ¦¦¦¦¦¦¦ ¦    ¦ ¦                    ¦    ¦ ¦ ¦ ¦ ¦ ¦   ¦   ¦
¦ ¦    ¦ ¦ ¦¦¦¦¦¦¦¦¦¦       ¦ ¦¦¦¦ ¦¦¦¦¦¦¦¦¦¦¦¦ ¦ ¦¦¦¦¦¦¦¦¦¦ ¦ ¦ ¦ ¦ ¦ ¦ ¦ ¦ ¦ ¦
¦ ¦ ¦¦ ¦     ¦      ¦ ¦¦¦ ¦¦¦      ¦          ¦ ¦          ¦ ¦   ¦   ¦ ¦ ¦ ¦¦¦ ¦
¦ ¦  ¦ ¦¦ ¦¦ ¦ ¦¦ ¦ ¦ ¦ ¦¦¦   ¦¦¦¦¦¦ ¦¦¦¦¦¦¦¦ ¦ ¦ ¦¦¦¦ ¦¦¦ ¦ ¦¦¦¦¦¦¦¦¦ ¦ ¦   ¦ ¦
¦ ¦¦¦¦     ¦ ¦¦¦  ¦¦¦     ¦ ¦ ¦             ¦ ¦¦¦ ¦  ¦ ¦ ¦ ¦   ¦   ¦   ¦ ¦ ¦ ¦ ¦
¦    ¦¦ ¦¦¦¦   ¦ ¦ ¦¦¦¦¦¦ ¦ ¦ ¦¦¦¦¦¦¦¦¦¦¦¦¦ ¦     ¦  ¦ ¦ ¦   ¦   ¦   ¦ ¦ ¦ ¦ ¦ ¦
¦¦ ¦ ¦¦ ¦¦¦  ¦¦¦ ¦      ¦ ¦ ¦ ¦       ¦   ¦ ¦¦¦¦¦¦¦  ¦ ¦ ¦¦¦¦¦¦¦¦¦¦¦¦¦¦¦ ¦ ¦ ¦ ¦
¦  ¦  ¦¦¦ ¦ ¦¦   ¦ ¦¦¦¦¦¦ ¦ ¦ ¦ ¦¦¦¦¦ ¦ ¦   ¦¦ ¦     ¦ ¦                 ¦ ¦ ¦ ¦
¦  ¦  ¦  ¦¦  ¦ ¦ ¦ ¦      ¦ ¦   ¦   ¦ ¦¦¦ ¦ ¦¦ ¦ ¦ ¦¦¦ ¦ ¦¦¦¦¦ ¦¦¦¦¦¦¦ ¦¦¦ ¦ ¦ ¦
¦¦ ¦    ¦¦¦ ¦¦¦¦ ¦ ¦ ¦¦¦¦¦¦¦¦¦¦¦¦ ¦ ¦     ¦    ¦ ¦     ¦ ¦   ¦       ¦  ¦  ¦ ¦¦¦
¦¦ ¦ ¦¦¦¦   ¦      ¦            ¦ ¦ ¦¦¦¦¦¦¦¦¦¦¦¦ ¦ ¦ ¦¦¦ ¦ ¦ ¦¦¦¦¦¦¦ ¦  ¦ ¦¦   ¦
¦¦ ¦  ¦   ¦   ¦¦¦¦¦¦ ¦¦¦¦¦¦¦¦¦¦   ¦            ¦   ¦     ¦ ¦   ¦   ¦ ¦  ¦  ¦ ¦ ¦
¦  ¦  ¦ ¦¦¦¦¦¦¦      ¦        ¦¦¦¦¦ ¦¦¦¦¦¦¦¦¦¦¦¦¦¦¦¦¦ ¦¦¦¦ ¦ ¦ ¦ ¦ ¦ ¦¦¦¦¦¦¦ ¦ ¦
¦ ¦¦  ¦         ¦¦¦¦¦¦  ¦¦  ¦ ¦   ¦ ¦   ¦   ¦   ¦   ¦      ¦ ¦ ¦ ¦ ¦ ¦   ¦   ¦ ¦
¦ ¦¦ ¦¦¦¦¦¦¦¦¦¦¦¦¦     ¦¦  ¦¦ ¦¦¦ ¦ ¦ ¦ ¦ ¦ ¦ ¦ ¦ ¦ ¦¦¦¦¦¦ ¦ ¦ ¦ ¦ ¦ ¦ ¦ ¦ ¦¦¦¦¦
¦                  ¦¦¦¦¦  ¦¦      ¦   ¦   ¦   ¦   ¦      ¦ ¦ ¦   ¦ ¦   ¦ ¦      
¦¦¦¦¦¦¦¦¦¦¦¦¦¦¦¦¦¦¦¦¦¦¦¦¦¦¦¦¦¦¦¦¦¦¦¦¦¦¦¦¦¦¦¦¦¦¦¦¦¦¦¦¦¦¦¦¦¦¦¦¦¦¦¦¦¦¦¦¦¦¦¦¦¦¦¦¦¦¦¦